-1 -1 -1 -1 -1 -1 -1 -1 -1 -1 -1 -1 -1 -1 -1 -1 -1 -1 -1 -1 -1 -1 -1 -1 -1 -1 -1 -1 -1 -1 -1 -1 -1 -1 -1 -1 -1 -1 -1 -1 -1 -1 -1 -1 -1 -1 -1 -1 -1 -1
-1 -1 -1 -1 -1 -1 -1 -1 -1 -1 -1 -1 -1 -1 -1 -1 -1 -1 -1 -1 -1 -1 -1 -1 -1 -1 -1 -1 -1 -1 -1 -1 -1 -1 -1 -1 -1 -1 -1 -1 -1 -1 -1 -1 -1 -1 -1 -1 -1 -1
-1 -1 -1 -1 -1 -1 -1 -1 -1 -1 -1 -1 -1 -1 -1 -1 -1 -1 -1 -1 -1 -1 -1 -1 -1 -1 -1 -1 -1 -1 -1 -1 -1 -1 -1 -1 -1 -1 -1 -1 -1 -1 -1 -1 -1 -1 -1 -1 -1 -1
-1 -1 -1 -1 -1 -1 -1 -1 -1 -1 -1 -1 -1 -1 -1 -1 -1 -1 -1 -1 -1 -1 -1 -1 -1 -1 -1 -1 -1 -1 -1 -1 -1 -1 -1 -1 -1 -1 -1 -1 -1 -1 -1 -1 -1 -1 -1 -1 -1 -1
-1 -1 -1 -1 -1 -1 -1 -1 -1 -1 -1 -1 -1 -1 -1 -1 -1 -1 -1 -1 -1 -1 -1 -1 -1 -1 -1 -1 -1 -1 -1 -1 -1 -1 -1 -1 -1 -1 -1 -1 -1 -1 -1 -1 -1 -1 -1 -1 -1 -1
-1 -1 -1 -1 -1 -1 -1 -1 -1 -1 -1 -1 -1 -1 -1 -1 -1 -1 -1 -1 -1 -1 -1 -1 -1 -1 -1 -1 -1 -1 -1 -1 -1 -1 -1 -1 -1 -1 -1 -1 -1 -1 -1 -1 -1 -1 -1 -1 -1 -1
-1 -1 -1 -1 -1 -1 -1 -1 -1 -1 -1 -1 -1 -1 -1 -1 -1 -1 -1 -1 -1 -1 -1 -1 -1 -1 -1 -1 -1 -1 -1 -1 -1 -1 -1 -1 -1 -1 -1 -1 -1 -1 -1 -1 -1 -1 -1 -1 -1 -1
-1 -1 -1 -1 -1 -1 -1 -1 -1 -1 -1 -1 -1 -1 -1 -1 -1 -1 -1 -1 -1 -1 -1 -1 -1 -1 502 503 504 505 506 507 508 509 -1 -1 -1 -1 -1 -1 -1 -1 -1 -1 -1 -1 -1 -1 -1 -1
-1 -1 -1 -1 -1 -1 -1 -1 -1 -1 -1 37 38 39 40 41 42 43 -1 -1 -1 -1 -1 -1 -1 -1 598 599 600 601 602 603 604 605 -1 -1 -1 -1 -1 -1 -1 44 45 45 46 46 47 -1 -1 -1
-1 -1 -1 -1 -1 -1 -1 -1 -1 -1 -1 133 134 135 136 137 134 139 -1 -1 -1 -1 -1 -1 -1 -1 694 695 696 697 698 699 700 701 -1 1254 1255 1256 1257 -1 -1 140 141 141 142 142 143 -1 -1 -1
-1 -1 -1 -1 -1 -1 -1 -1 -1 -1 -1 229 230 231 232 233 234 139 -1 -1 -1 -1 -1 -1 -1 -1 790 791 792 793 794 795 796 797 -1 1350 1351 1352 1353 -1 -1 236 237 237 238 238 239 -1 -1 -1
-1 -1 -1 -1 -1 -1 -1 -1 -1 -1 -1 229 326 134 134 134 330 235 -1 -1 1254 1255 1256 1257 -1 -1 886 887 888 889 890 891 892 893 -1 1446 1447 1448 1449 -1 -1 332 333 333 334 334 335 -1 -1 -1
-1 -1 -1 -1 -1 -1 -1 -1 -1 -1 -1 325 422 134 134 134 426 331 -1 -1 1350 1351 1352 1353 -1 -1 982 983 984 985 986 987 988 989 -1 1542 1543 1544 1545 -1 -1 428 429 430 431 432 433 -1 -1 -1
-1 -1 -1 -1 -1 -1 -1 992 993 994 995 421 511 511 511 511 511 427 999 1000 1446 1447 1448 1449 -1 -1 1078 1079 1080 1081 1082 1083 1084 1085 -1 -1 -1 -1 -1 -1 -1 524 525 526 527 528 529 -1 -1 -1
-1 -1 -1 -1 -1 -1 -1 1088 1089 1090 1091 606 607 608 609 615 616 619 1095 1096 1542 1543 1544 1545 -1 -1 1174 1175 1176 1177 1178 1179 1180 1181 502 503 504 505 506 507 508 509 -1 -1 -1 -1 -1 -1 -1 -1
-1 -1 -1 -1 -1 -1 -1 1184 1185 1186 1187 702 703 704 705 711 712 715 1191 1192 -1 -1 -1 -1 -1 -1 1270 1271 1272 1273 1274 1275 1276 1277 598 599 600 601 602 603 604 605 -1 -1 -1 -1 -1 -1 -1 -1
-1 -1 -1 -1 -1 -1 -1 -1 -1 -1 -1 -1 -1 -1 -1 221 221 221 -1 -1 -1 -1 -1 -1 -1 -1 1366 1367 1368 1369 1370 1371 1372 1373 694 695 696 697 698 699 700 701 -1 -1 -1 -1 -1 -1 -1 -1
-1 -1 -1 -1 -1 -1 -1 -1 -1 -1 -1 -1 -1 -1 -1 -1 -1 -1 -1 -1 -1 -1 -1 -1 -1 -1 -1 -1 -1 -1 -1 -1 -1 -1 790 791 792 793 794 795 796 797 -1 -1 -1 -1 -1 -1 -1 -1
-1 -1 -1 -1 -1 -1 -1 -1 -1 -1 -1 -1 -1 -1 -1 -1 -1 2434 2435 2436 2437 -1 -1 -1 -1 -1 -1 -1 -1 -1 -1 -1 -1 -1 886 887 888 889 890 891 892 893 -1 -1 -1 -1 -1 -1 -1 -1
-1 -1 -1 -1 -1 -1 -1 -1 -1 -1 -1 -1 -1 -1 -1 -1 -1 2530 2531 2532 2533 -1 -1 -1 -1 502 503 504 505 506 507 508 509 -1 982 983 984 985 986 987 988 989 -1 -1 -1 -1 -1 -1 -1 -1
-1 -1 -1 -1 -1 -1 -1 -1 -1 -1 -1 -1 -1 -1 -1 -1 -1 2626 2627 2628 2629 -1 -1 -1 -1 598 599 600 601 602 603 604 605 -1 1078 1079 1080 1081 1082 1083 1084 1085 -1 -1 -1 -1 -1 -1 -1 -1
-1 -1 -1 -1 -1 -1 -1 -1 -1 -1 -1 -1 -1 -1 -1 -1 -1 2722 2723 2724 2725 -1 -1 -1 -1 694 695 696 697 698 699 700 701 -1 1174 1175 1176 1177 1178 1179 1180 1181 -1 -1 -1 -1 -1 -1 -1 -1
-1 -1 -1 -1 -1 -1 -1 -1 -1 -1 -1 -1 -1 -1 -1 -1 -1 -1 -1 -1 -1 -1 -1 -1 -1 790 791 792 793 794 795 796 797 -1 1270 1271 1272 1273 1274 1275 1276 1277 -1 -1 -1 -1 -1 -1 -1 -1
-1 -1 -1 -1 -1 -1 -1 -1 -1 -1 -1 -1 -1 -1 -1 -1 -1 -1 -1 -1 -1 -1 -1 -1 -1 886 887 888 889 890 891 892 893 -1 1366 1367 1368 1369 1370 1371 1372 1373 -1 -1 -1 -1 -1 -1 -1 -1
-1 -1 -1 -1 -1 -1 -1 -1 -1 -1 -1 -1 3174 3175 3558 3558 3558 3558 3558 3558 3558 3558 3176 3177 -1 982 983 984 985 986 987 988 989 -1 -1 -1 -1 -1 -1 -1 -1 -1 -1 -1 -1 -1 -1 -1 -1 -1
-1 -1 -1 -1 -1 -1 -1 -1 -1 -1 -1 -1 3270 3271 2 2 2 483 483 2 2 2 3272 3273 -1 1078 1079 1080 1081 1082 1083 1084 1085 -1 -1 -1 -1 -1 -1 -1 -1 -1 -1 -1 -1 -1 -1 -1 -1 -1
-1 -1 -1 -1 -1 -1 -1 -1 -1 -1 -1 3270 3271 2 2 483 483 483 2 483 2 2 3368 -1 -1 1174 1175 1176 1177 1178 1179 1180 1181 -1 -1 -1 -1 -1 -1 -1 -1 -1 -1 -1 -1 -1 -1 -1 -1 -1
-1 -1 -1 -1 -1 -1 -1 -1 -1 -1 -1 3366 3367 2 2 2 2 483 2 2 2 3368 3464 -1 -1 1270 1271 1272 1273 1274 1275 1276 1277 -1 -1 -1 -1 -1 -1 -1 -1 -1 -1 -1 -1 -1 -1 -1 -1 -1
-1 -1 -1 -1 -1 -1 -1 -1 -1 -1 -1 -1 -1 3654 3655 3655 3655 3655 3655 3655 3654 3465 -1 -1 -1 1366 1367 1368 1369 1370 1371 1372 1373 -1 -1 -1 -1 -1 -1 -1 -1 -1 -1 -1 -1 -1 -1 -1 -1 -1
-1 -1 -1 -1 -1 -1 -1 -1 -1 -1 -1 -1 -1 -1 -1 -1 -1 -1 -1 -1 -1 -1 -1 -1 -1 -1 -1 -1 -1 -1 -1 -1 -1 -1 -1 -1 -1 -1 -1 -1 -1 -1 -1 -1 -1 -1 -1 -1 -1 -1
-1 -1 -1 -1 -1 -1 -1 -1 -1 -1 -1 -1 -1 -1 -1 -1 -1 -1 -1 -1 -1 -1 -1 -1 -1 -1 -1 -1 -1 -1 -1 -1 -1 -1 -1 -1 -1 -1 -1 -1 -1 -1 -1 -1 -1 -1 -1 -1 -1 -1
-1 -1 -1 -1 -1 -1 -1 -1 -1 -1 -1 -1 -1 -1 -1 -1 -1 -1 -1 -1 -1 -1 -1 -1 -1 -1 -1 -1 -1 -1 -1 -1 -1 -1 -1 -1 -1 -1 -1 -1 -1 -1 -1 -1 -1 -1 -1 -1 -1 -1
-1 -1 -1 -1 -1 -1 -1 -1 -1 -1 -1 -1 -1 -1 -1 -1 -1 -1 -1 -1 -1 -1 -1 -1 -1 -1 -1 -1 -1 -1 -1 -1 -1 -1 -1 -1 -1 -1 -1 -1 -1 -1 -1 -1 -1 -1 -1 -1 -1 -1
-1 -1 -1 -1 -1 -1 -1 -1 -1 -1 -1 -1 -1 -1 -1 -1 -1 -1 -1 -1 -1 -1 -1 -1 -1 -1 -1 -1 -1 -1 -1 -1 -1 -1 -1 -1 -1 -1 -1 -1 -1 -1 -1 -1 -1 -1 -1 -1 -1 -1
-1 -1 -1 -1 -1 -1 -1 -1 -1 -1 -1 -1 -1 -1 -1 -1 -1 -1 -1 -1 -1 -1 -1 -1 -1 -1 -1 -1 -1 -1 -1 -1 -1 -1 -1 -1 -1 -1 -1 -1 -1 -1 -1 -1 -1 -1 -1 -1 -1 -1
-1 -1 -1 -1 -1 -1 -1 -1 -1 -1 -1 -1 -1 -1 -1 -1 -1 -1 -1 -1 -1 -1 -1 -1 -1 -1 -1 -1 -1 -1 -1 -1 -1 -1 -1 -1 -1 -1 -1 -1 -1 -1 -1 -1 -1 -1 -1 -1 -1 -1
-1 -1 -1 -1 -1 -1 -1 -1 -1 -1 -1 -1 -1 -1 -1 -1 -1 -1 -1 -1 -1 -1 -1 -1 -1 -1 -1 -1 -1 -1 -1 -1 -1 -1 -1 -1 -1 -1 -1 -1 -1 -1 -1 -1 -1 -1 -1 -1 -1 -1
-1 -1 -1 -1 -1 -1 -1 -1 -1 -1 -1 -1 -1 -1 -1 -1 -1 -1 -1 -1 -1 -1 -1 -1 -1 -1 -1 -1 -1 -1 -1 -1 -1 -1 -1 -1 -1 -1 -1 -1 -1 -1 -1 -1 -1 -1 -1 -1 -1 -1
