0 1 1 1 1 1 1 1 1 1 1 1 1 1 1 1 1 1 1 1 1 1 1 1 1 1 1 1 1 1 1 1 1 1 1 1 1 1 1 1 1 1 1 1 1 1 1 1 1 2
40 120 121 121 121 121 121 121 121 121 121 121 121 121 121 121 121 121 121 121 121 121 121 121 121 121 121 121 121 121 121 121 121 121 121 121 121 121 121 121 121 121 121 121 121 121 121 121 122 42
40 160 573 573 573 573 573 573 573 573 573 573 573 573 573 573 573 573 573 573 573 573 573 573 573 573 573 573 573 573 573 573 573 573 573 573 573 573 573 573 573 573 573 573 573 573 573 573 162 42
40 160 573 573 573 573 573 573 573 573 573 573 573 573 573 573 573 573 573 573 573 573 573 573 573 573 573 573 573 573 573 573 573 573 573 573 573 573 573 573 573 573 573 573 573 573 573 573 162 42
40 160 573 573 573 573 573 573 573 573 573 573 573 573 573 573 573 573 573 573 573 573 573 573 573 573 573 573 573 573 573 573 573 573 573 573 573 573 573 573 573 573 573 573 573 573 573 573 162 42
40 160 573 573 573 573 573 573 573 573 573 573 573 573 573 573 573 573 573 573 573 573 573 573 573 573 573 573 573 573 573 573 573 573 573 573 573 573 573 573 573 573 573 573 573 573 573 573 162 42
40 160 573 573 573 573 573 573 573 573 573 573 573 573 573 573 573 573 573 573 573 573 573 573 573 573 573 573 573 604 573 573 573 573 573 573 573 573 573 573 573 573 573 573 573 573 573 573 162 42
40 160 573 573 573 573 573 573 573 573 573 573 573 573 573 573 573 573 573 375 573 573 573 573 573 573 573 573 573 573 573 573 573 573 573 573 573 573 573 573 573 573 573 573 573 573 573 573 162 42
40 160 573 573 573 573 573 573 573 573 573 573 573 573 375 573 573 573 375 375 573 573 573 573 573 573 573 375 573 573 573 573 573 573 375 375 573 573 573 573 573 573 573 573 573 573 573 573 162 42
40 160 573 573 573 573 573 573 573 573 573 375 375 375 807 573 375 375 375 375 573 573 573 375 573 573 375 375 375 573 573 375 573 375 375 573 573 573 573 573 573 573 573 573 573 573 573 573 162 42
40 160 573 573 573 573 573 573 573 573 375 375 807 807 807 375 375 375 375 375 375 375 375 573 573 375 375 375 375 573 375 375 375 375 573 573 573 573 573 573 573 573 688 573 573 573 573 573 162 42
40 160 573 573 573 573 573 573 573 375 375 807 807 807 375 375 375 375 375 375 375 375 375 375 375 375 375 375 375 375 375 375 573 573 573 573 573 573 573 573 573 573 573 573 573 573 573 573 162 42
40 160 573 573 573 573 573 573 375 375 375 375 375 375 375 375 375 375 375 375 375 375 375 375 375 375 375 375 375 375 375 573 573 573 573 573 573 573 573 573 573 573 573 573 573 573 573 573 162 42
40 160 573 573 573 573 375 375 375 375 375 375 375 375 375 375 375 375 375 375 375 375 375 375 375 807 375 375 375 375 573 573 573 573 573 573 573 573 573 573 573 573 573 573 573 573 573 573 162 42
40 160 573 573 573 573 375 573 375 375 375 375 375 375 375 375 375 375 375 688 688 375 807 807 807 807 375 375 602 375 375 375 573 573 604 573 573 573 573 573 573 573 573 573 573 573 573 573 162 42
40 160 573 573 573 375 375 375 375 807 807 807 375 375 375 375 375 375 375 688 375 375 807 807 807 375 375 375 375 375 375 573 573 573 573 573 573 573 573 573 573 573 573 573 573 573 573 573 162 42
40 160 573 573 573 573 573 573 807 807 807 807 807 375 375 375 375 375 375 688 375 375 375 807 807 375 375 375 375 375 375 295 573 573 573 573 573 573 573 573 573 573 573 573 573 573 573 573 162 42
40 160 573 573 573 573 573 573 375 807 807 807 807 375 375 375 375 375 688 688 375 375 375 375 375 375 375 375 375 295 295 295 573 573 573 573 573 573 573 573 573 573 573 573 573 573 573 573 162 42
40 160 573 573 573 573 573 375 375 375 807 807 375 295 375 375 375 688 375 375 375 375 375 375 375 375 375 375 375 295 573 295 573 573 573 573 573 573 573 573 573 573 573 573 573 573 573 573 162 42
40 160 573 573 573 573 573 375 375 573 573 375 375 375 375 375 375 375 375 375 375 375 375 375 375 375 375 375 295 573 573 295 573 573 573 573 573 573 573 573 573 573 573 573 573 573 573 573 162 42
40 160 573 573 573 573 375 375 573 375 375 375 375 573 375 375 375 375 375 375 375 375 375 375 375 375 375 295 573 573 573 295 573 573 573 573 573 573 573 573 573 602 573 573 573 573 573 573 162 42
40 160 573 573 573 573 375 375 375 573 375 375 573 573 375 295 375 375 375 375 375 375 375 375 375 375 295 295 295 573 573 295 688 573 573 573 573 573 573 573 573 573 573 573 573 573 573 573 162 42
40 160 573 573 573 573 375 573 573 573 573 573 573 375 375 375 375 375 375 375 295 375 375 375 375 295 573 573 573 295 600 573 573 573 573 573 573 573 573 573 573 573 573 573 573 573 573 573 162 42
40 160 573 573 573 573 573 573 573 573 573 295 295 375 375 375 573 295 295 295 375 375 375 375 295 295 295 295 295 295 295 295 573 573 573 573 573 573 573 573 573 573 573 573 573 573 573 573 162 42
40 160 573 573 573 573 573 573 573 573 295 295 375 375 375 295 295 295 573 573 295 295 375 573 573 573 295 295 295 573 573 573 295 573 573 573 573 573 573 573 573 573 573 573 573 573 573 573 162 42
40 160 573 573 573 573 573 573 573 573 295 375 375 375 295 295 573 573 573 573 295 295 295 573 573 573 573 573 573 573 295 573 573 295 295 573 573 573 573 573 573 573 573 573 573 573 573 573 162 42
40 160 573 573 573 573 573 573 573 573 375 375 375 295 295 688 573 573 573 295 573 573 573 295 295 573 573 573 573 807 573 573 573 573 573 295 573 573 573 573 573 573 573 573 573 573 573 573 162 42
40 160 573 573 573 573 573 573 573 375 375 375 573 573 573 573 573 573 573 573 573 573 573 573 573 295 295 807 807 807 573 573 573 573 573 295 573 573 573 573 573 573 573 573 573 573 573 573 162 42
40 160 573 573 573 573 573 573 573 375 375 573 573 573 573 573 573 573 573 573 573 573 573 573 573 573 807 807 807 295 295 573 573 573 573 573 295 688 573 573 573 573 573 573 573 573 573 573 162 42
40 160 573 573 573 573 573 573 573 375 573 573 573 573 573 573 573 573 573 573 573 573 573 573 573 573 573 573 573 573 573 295 295 295 295 295 295 573 573 573 573 573 573 573 573 573 573 573 162 42
40 160 573 573 573 573 573 573 573 573 573 573 573 573 573 573 573 573 573 573 573 573 573 573 573 573 573 573 573 573 573 573 573 573 573 573 573 573 573 573 573 573 573 573 573 573 573 573 162 42
40 160 573 573 573 573 573 573 573 573 573 573 573 573 573 573 573 573 573 573 573 573 573 573 573 573 573 573 573 573 573 573 573 573 573 573 573 573 573 573 573 573 573 573 573 573 573 573 162 42
40 160 573 573 573 573 573 573 573 573 573 573 573 573 573 573 573 573 573 573 573 573 573 573 573 573 573 573 573 573 573 573 573 573 573 573 573 573 573 573 573 573 573 573 573 573 573 573 162 42
40 160 573 573 573 573 573 573 573 573 573 573 573 573 573 573 573 573 573 573 573 573 573 573 573 573 573 573 573 573 573 573 573 573 573 573 573 573 573 573 573 573 573 573 573 573 573 573 162 42
40 160 573 573 573 573 573 573 573 573 573 573 573 573 573 573 573 573 573 573 573 573 573 573 573 573 573 573 573 573 573 573 573 573 573 573 573 573 573 573 573 573 573 573 573 573 573 573 162 42
40 160 573 573 573 573 573 573 573 573 573 573 573 573 573 573 573 573 573 573 688 776 777 688 573 573 573 573 573 573 573 573 573 573 573 573 573 573 573 573 573 573 573 573 573 573 573 573 162 42
40 200 201 201 201 201 201 201 201 201 201 201 201 201 201 201 201 201 201 201 201 816 817 201 201 201 201 201 201 201 201 201 201 201 201 201 201 201 201 201 201 201 201 201 201 201 201 201 202 42
80 81 81 81 81 81 81 81 81 81 81 81 81 81 81 81 81 81 81 81 81 688 688 81 81 81 81 81 81 81 81 81 81 81 81 81 81 81 81 81 81 81 81 81 81 81 81 81 81 82
